111111111111111111
11100E0000000P0001
1C1100000000000011
111111111111111111